.........D8.
.........D..
W...-.......
---M.S---M..
W...-..-..--
------M.S---
W......-....
-RRRRRRRR...