.........D8.
.........D..
W...-.......
---S.S---S..
W...-..-..--
------S.S---
W......-....
-RRRRRRRR...